#####
#.$@#
#####

##############      ##############
#.$@         # ###### $         .#
############ # #      ############
           # ### #### #
########## #     #  # # ##########
#        # # #####  # # #        #
# ######$# # #      # # #$###### #
# #    #.# # #####  # # #.#    # #
# #    ### #     #  # # ###    # #
# #        # ### #  # #        # #
# ########## # # #  # ########## #
#            # # #  #            #
############## # #  ############ #
               # #             # #
################ #### ### ###### #
#                $ .# #.# #      #
# ###### ############ # # #$#### #
# #    # #            # # # #  # #
# #    # # ########## # # # #  # #
# #### # # #.     $ # # # # #  # #
# $ .# # # ######## # # # #.#  # #
###### # #        # # # # ###  # #
       # #        # # # #      # #
######## ########## # #$######## #
#.     $            # #          #
##################### ############

####  ###  #  ###  ###################
###  ###  ###  #  ##########    ######
##  ###  ##.##   ##   ####.$ ##  #####
#  ###  ###$### ##  #  #####  ##  ####
  ###  ##    ####  ###  #####  ## $.##
 ###  ##  ## ###  ##.##  #####  ######
###  ##  ##  ##  ###$###  #####  #####
##  ##  ##  ##  ###   ###  #####  ####
#  ##  ##  ##  ###  #  ###  ##### $.##
  ### ### ##  ###  ###  ###  ###  ####
 ####  ##  # ###  #####  ###  #  ####
##@ ##  ##   ##  ##   ##  ###   ####
 ##  ##  #####  ##  #  ##  ###$####  #
  ##  ##  ###  ##  ###  ##  ##.###  ##
#  ##  ##  #  ##  ## ##  ##  ####  ###
##  ##  ##   ##  ##   ##  ##  ####  ##
###  ##  #####  ##  #  ##  ##  ####  #
 ###  ##  ###  ##  ###  ##  ## #####
  ###  ##  #  ##  #####  ##  # $.##  #
#  ###  ##   ##  #######  ##   ###  ##
##  ###  ##$##  #########  ##$###  ###
###  ###  #.#  ###########  #.##  ####
####  ### ### ############# ###  #####