#####
#.$@#
#####

##############      ##############
#.$@         # ###### $         .#
############ # #      ############
           # ### #### #
########## #     #  # # ##########
#        # # #####  # # #        #
# ######$# # #      # # #$###### #
# #    #.# # #####  # # #.#    # #
# #    ### #     #  # # ###    # #
# #        # ### #  # #        # #
# ########## # # #  # ########## #
#            # # #  #            #
############## # #  ############ #
               # #             # #
################ #### ### ###### #
#                $ .# #.# #      #
# ###### ############ # # #$#### #
# #    # #            # # # #  # #
# #    # # ########## # # # #  # #
# #### # # #.     $ # # # # #  # #
# $ .# # # ######## # # # #.#  # #
###### # #        # # # # ###  # #
       # #        # # # #      # #
######## ########## # #$######## #
#.     $            # #          #
##################### ############

#########  #  ###  ###################
########  ###  #  ##########    ######
#######  ##.##   ##   ####.$ ##  #####
######  ###$### ##  #  #####  ##  ####
#####  ##    ####  ###  #####  ## $.##
####  ##  ## ###  ##.##  #####  ######
###  ##  ##  ##  ###$###  #####  #####
##  ##  ##  ##  ###   ###  #####  ####
#  ##  ##  ##  ###  #  ###  ##### $.##
  ### ### ##  ###  ###  ###  ###  ####
 ####  ##  # ###  #####  ###  #  #####
##@ ##  ##   ##  ##   ##  ###   ######
 ##  ##  #####  ##  #  ##  ###$#######
  ##  ##  ###  ##  ###  ##  ##.#######
#  ##  ##  #  ##  ## ##  ##  ####  ###
##  ##  ##   ##  ##   ##  ##  ####  ##
###  ##  #####  ##  #  ##  ##  ####  #
####  ##  ###  ##  ###  ##  ## #####
#####  ##  #  ##  #####  ##  # $.##  #
######  ##   ##  #######  ##   ###  ##
#######  ##$##  #########  ##$###  ###
########  #.#  ###########  #.##  ####
######### ### ############# ###  #####